-3 -3 -3 -3 -3 -3 -3 -3 -5
-2 -1 1 1 1 1 1 1 -5
-2 -1 1 1 1 0 0 0 -5
-2 -1 1 0 0 0 0 0 -5
-2 -1 1 0 0 1 0 0 -5
-2 -1 1 0 0 1 0 0 -5
-2 -1 0 0 0 1 0 0 -5
-2 -1 0 0 1 1 0 0 -5
-4 -4 -4 -4 -4 -4 -4 -4 -5